....................
..........#####.....
..............#.....
..............#.....
..............#.....
..............#.....
....#.........#.....
....#.........#.....
....#...............
....#...............
....#...............
....######..........
....................
....................
....................