....................
............#.......
...#.........#......
....#.........#.....
.....#.........###..
......#.............
.......#......#.....
........#....#......
.........#..#.......
..........##........
..........##........
.........#..#.......
........#....#......
.......#......#.....
......#........#....