....................
....................
..###..........#....
...............#....
...............#....
...............#....
...............#....
...............#....
....................
....#####...........
....................
....................
....................
..........#####.....
....................